type octile
height 3
width 5
map
@.@@@
.....
@.@@@
