type octile
height 5
width 7
map
@.@@@@@
.......
@.@.@@@
@@@.@@@
@@@.@@@
