type octile
height 2
width 2
map
..
@.