type octile
height 10
width 11
map
@@@@@@@@@@@
@....@....@
@....@....@
@....@....@
@....@....@
@....@....@
@....@....@
@....@....@
@....@....@
@@@@@@@@@@@
