type octile
height 26
width 40
map
........................................
........................................
........................................
........................................
........................................
........................................
......@@@@@@...@@@@@@@@@@...@@@@@@......
......@..........................@......
......@....@@@@..........@@@@....@......
...........@................@...........
........................................
......@..........................@......
......@..........................@......
......@..........................@......
......@..........................@......
........................................
........................................
......@..........................@......
......@..........................@......
......@@@@@@...@@@@@@@@@@...@@@@@@......
........................................
........................................
........................................
........................................
........................................
........................................